Day,Temperature,Humidity,Windspeed,Rentals,Weekday,Registered,Casual
1,0.344167,0.805833,0.160446,985,6,654,331
2,0.363478,0.696087,0.248539,801,0,670,131
3,0.196364,0.437273,0.248309,1349,1,1229,120
4,0.2,0.590435,0.160296,1562,2,1454,108
5,0.226957,0.436957,0.1869,1600,3,1518,82
6,0.204348,0.518261,0.0895652,1606,4,1518,88
7,0.196522,0.498696,0.168726,1510,5,1362,148
8,0.165,0.535833,0.266804,959,6,891,68
9,0.138333,0.434167,0.36195,822,0,768,54
10,0.150833,0.482917,0.223267,1321,1,1280,41
11,0.169091,0.686364,0.122132,1263,2,1220,43
12,0.172727,0.599545,0.304627,1162,3,1137,25
13,0.165,0.470417,0.301,1406,4,1368,38
14,0.16087,0.537826,0.126548,1421,5,1367,54
15,0.233333,0.49875,0.157963,1248,6,1026,222
16,0.231667,0.48375,0.188433,1204,0,953,251
17,0.175833,0.5375,0.194017,1000,1,883,117
18,0.216667,0.861667,0.146775,683,2,674,9
19,0.292174,0.741739,0.208317,1650,3,1572,78
20,0.261667,0.538333,0.195904,1927,4,1844,83
21,0.1775,0.457083,0.353242,1543,5,1468,75
22,0.0591304,0.4,0.17197,981,6,888,93
23,0.0965217,0.436522,0.2466,986,0,836,150
24,0.0973913,0.491739,0.15833,1416,1,1330,86
25,0.223478,0.616957,0.129796,1985,2,1799,186
26,0.2175,0.8625,0.29385,506,3,472,34
27,0.195,0.6875,0.113837,431,4,416,15
28,0.203478,0.793043,0.1233,1167,5,1129,38
29,0.196522,0.651739,0.145365,1098,6,975,123
30,0.216522,0.722174,0.0739826,1096,0,956,140
31,0.180833,0.60375,0.187192,1501,1,1459,42
32,0.192174,0.829565,0.053213,1360,2,1313,47
33,0.26,0.775417,0.264308,1526,3,1454,72
34,0.186957,0.437826,0.277752,1550,4,1489,61
35,0.211304,0.585217,0.127839,1708,5,1620,88
36,0.233333,0.929167,0.161079,1005,6,905,100
37,0.285833,0.568333,0.1418,1623,0,1269,354
38,0.271667,0.738333,0.0454083,1712,1,1592,120
39,0.220833,0.537917,0.36195,1530,2,1466,64
40,0.134783,0.494783,0.188839,1605,3,1552,53
41,0.144348,0.437391,0.221935,1538,4,1491,47
42,0.189091,0.506364,0.10855,1746,5,1597,149
43,0.2225,0.544167,0.203367,1472,6,1184,288
44,0.316522,0.457391,0.260883,1589,0,1192,397
45,0.415,0.375833,0.417908,1913,1,1705,208
46,0.266087,0.314348,0.291374,1815,2,1675,140
47,0.318261,0.423478,0.251791,2115,3,1897,218
48,0.435833,0.505,0.230104,2475,4,2216,259
49,0.521667,0.516667,0.264925,2927,5,2348,579
50,0.399167,0.187917,0.507463,1635,6,1103,532
51,0.285217,0.407826,0.223235,1812,0,1173,639
52,0.303333,0.605,0.307846,1107,1,912,195
53,0.182222,0.577778,0.195683,1450,2,1376,74
54,0.221739,0.423043,0.094113,1917,3,1778,139
55,0.295652,0.697391,0.250496,1807,4,1707,100
56,0.364348,0.712174,0.346539,1461,5,1341,120
57,0.2825,0.537917,0.186571,1969,6,1545,424
58,0.343478,0.68,0.125248,2402,0,1708,694
59,0.407273,0.876364,0.289686,1446,1,1365,81
60,0.266667,0.535,0.216425,1851,2,1714,137
61,0.335,0.449583,0.307833,2134,3,1903,231
62,0.198333,0.318333,0.225754,1685,4,1562,123
63,0.261667,0.610417,0.203346,1944,5,1730,214
64,0.384167,0.789167,0.251871,2077,6,1437,640
65,0.376522,0.948261,0.343287,605,0,491,114
66,0.261739,0.551304,0.341352,1872,1,1628,244
67,0.2925,0.420833,0.12065,2133,2,1817,316
68,0.295833,0.775417,0.22015,1891,3,1700,191
69,0.389091,0,0.261877,623,4,577,46
70,0.316522,0.649565,0.23297,1977,5,1730,247
71,0.329167,0.594583,0.220775,2132,6,1408,724
72,0.384348,0.527391,0.270604,2417,0,1435,982
73,0.325217,0.496957,0.136926,2046,1,1687,359
74,0.317391,0.655652,0.184309,2056,2,1767,289
75,0.365217,0.776522,0.203117,2192,3,1871,321
76,0.415,0.602917,0.209579,2744,4,2320,424
77,0.54,0.525217,0.231017,3239,5,2355,884
78,0.4725,0.379167,0.368167,3117,6,1693,1424
79,0.3325,0.47375,0.207721,2471,0,1424,1047
80,0.430435,0.737391,0.288783,2077,1,1676,401
81,0.441667,0.624583,0.22575,2703,2,2243,460
82,0.346957,0.839565,0.234261,2121,3,1918,203
83,0.285,0.805833,0.243787,1865,4,1699,166
84,0.264167,0.495,0.230725,2210,5,1910,300
85,0.265833,0.394167,0.209571,2496,6,1515,981
86,0.253043,0.493913,0.1843,1693,0,1221,472
87,0.264348,0.302174,0.212204,2028,1,1806,222
88,0.3025,0.314167,0.226996,2425,2,2108,317
89,0.3,0.646667,0.172888,1536,3,1368,168
90,0.268333,0.918333,0.217646,1685,4,1506,179
91,0.3,0.68625,0.258708,2227,5,1920,307
92,0.315,0.65375,0.197146,2252,6,1354,898
93,0.378333,0.48,0.182213,3249,0,1598,1651
94,0.573333,0.42625,0.385571,3115,1,2381,734
95,0.414167,0.642083,0.388067,1795,2,1628,167
96,0.390833,0.470833,0.263063,2808,3,2395,413
97,0.4375,0.602917,0.162312,3141,4,2570,571
98,0.335833,0.83625,0.226992,1471,5,1299,172
99,0.3425,0.8775,0.133083,2455,6,1576,879
100,0.426667,0.8575,0.146767,2895,0,1707,1188
101,0.595652,0.716956,0.324474,3348,1,2493,855
102,0.5025,0.739167,0.274879,2034,2,1777,257
103,0.4125,0.819167,0.250617,2162,3,1953,209
104,0.4675,0.540417,0.1107,3267,4,2738,529
105,0.446667,0.67125,0.226375,3126,5,2484,642
106,0.430833,0.888333,0.340808,795,6,674,121
107,0.456667,0.479583,0.303496,3744,0,2186,1558
108,0.5125,0.5425,0.163567,3429,1,2760,669
109,0.505833,0.665833,0.157971,3204,2,2795,409
110,0.595,0.614167,0.241925,3944,3,3331,613
111,0.459167,0.407083,0.325258,4189,4,3444,745
112,0.336667,0.729583,0.219521,1683,5,1506,177
113,0.46,0.887917,0.230725,4036,6,2574,1462
114,0.581667,0.810833,0.192175,4191,0,2481,1710
115,0.606667,0.776667,0.185333,4073,1,3300,773
116,0.631667,0.729167,0.3265,4400,2,3722,678
117,0.62,0.835417,0.3122,3872,3,3325,547
118,0.6175,0.700833,0.320908,4058,4,3489,569
119,0.51,0.457083,0.240063,4595,5,3717,878
120,0.4725,0.503333,0.235075,5312,6,3347,1965
121,0.451667,0.762083,0.106354,3351,0,2213,1138
122,0.549167,0.73,0.183454,4401,1,3554,847
123,0.616667,0.697083,0.342667,4451,2,3848,603
124,0.414167,0.737083,0.328996,2633,3,2378,255
125,0.459167,0.444167,0.295392,4433,4,3819,614
126,0.479167,0.59,0.228246,4608,5,3714,894
127,0.52,0.54125,0.16045,4714,6,3102,1612
128,0.528333,0.631667,0.0746375,4333,0,2932,1401
129,0.5325,0.58875,0.176,4362,1,3698,664
130,0.5325,0.489167,0.115671,4803,2,4109,694
131,0.5425,0.632917,0.120642,4182,3,3632,550
132,0.535,0.7475,0.189667,4864,4,4169,695
133,0.5125,0.863333,0.179725,4105,5,3413,692
134,0.520833,0.9225,0.13495,3409,6,2507,902
135,0.5625,0.867083,0.152979,4553,0,2971,1582
136,0.5775,0.787917,0.126871,3958,1,3185,773
137,0.561667,0.837917,0.277354,4123,2,3445,678
138,0.55,0.87,0.201492,3855,3,3319,536
139,0.530833,0.829583,0.108213,4575,4,3840,735
140,0.536667,0.719583,0.125013,4917,5,4008,909
141,0.6025,0.626667,0.12065,5805,6,3547,2258
142,0.604167,0.749583,0.148008,4660,0,3084,1576
143,0.631667,0.81,0.233842,4274,1,3438,836
144,0.66,0.740833,0.207092,4492,2,3833,659
145,0.660833,0.69625,0.154233,4978,3,4238,740
146,0.708333,0.6775,0.199642,4677,4,3919,758
147,0.681667,0.65375,0.240679,4679,5,3808,871
148,0.655833,0.729583,0.230092,4758,6,2757,2001
149,0.6675,0.81875,0.213938,4788,0,2433,2355
150,0.733333,0.685,0.131225,4098,1,2549,1549
151,0.775,0.636667,0.111329,3982,2,3309,673
152,0.764167,0.677083,0.207092,3974,3,3461,513
153,0.715,0.305,0.292287,4968,4,4232,736
154,0.62,0.354167,0.253121,5312,5,4414,898
155,0.635,0.45625,0.123142,5342,6,3473,1869
156,0.648333,0.6525,0.138692,4906,0,3221,1685
157,0.678333,0.6,0.121896,4548,1,3875,673
158,0.7075,0.597917,0.187808,4833,2,4070,763
159,0.775833,0.622083,0.136817,4401,3,3725,676
160,0.808333,0.568333,0.149883,3915,4,3352,563
161,0.755,0.605,0.140554,4586,5,3771,815
162,0.725,0.654583,0.15485,4966,6,3237,1729
163,0.6925,0.747917,0.163567,4460,0,2993,1467
164,0.635,0.494583,0.30535,5020,1,4157,863
165,0.604167,0.507083,0.269283,4891,2,4164,727
166,0.626667,0.471667,0.167912,5180,3,4411,769
167,0.628333,0.688333,0.206471,3767,4,3222,545
168,0.649167,0.735833,0.143029,4844,5,3981,863
169,0.696667,0.670417,0.119408,5119,6,3312,1807
170,0.699167,0.666667,0.102,4744,0,3105,1639
171,0.635,0.74625,0.155475,4010,1,3311,699
172,0.680833,0.770417,0.171025,4835,2,4061,774
173,0.733333,0.7075,0.172262,4507,3,3846,661
174,0.728333,0.703333,0.238804,4790,4,4044,746
175,0.724167,0.573333,0.222025,4991,5,4022,969
176,0.695,0.483333,0.209571,5202,6,3420,1782
177,0.68,0.513333,0.0945333,5305,0,3385,1920
178,0.6825,0.658333,0.107588,4708,1,3854,854
179,0.744167,0.634167,0.144283,4648,2,3916,732
180,0.728333,0.497917,0.261821,5225,3,4377,848
181,0.696667,0.434167,0.185312,5515,4,4488,1027
182,0.7225,0.39625,0.102608,5362,5,4116,1246
183,0.738333,0.444583,0.115062,5119,6,2915,2204
184,0.716667,0.6825,0.228858,4649,0,2367,2282
185,0.726667,0.637917,0.0814792,6043,1,2978,3065
186,0.746667,0.590417,0.126258,4665,2,3634,1031
187,0.72,0.743333,0.149883,4629,3,3845,784
188,0.75,0.65125,0.1592,4592,4,3838,754
189,0.709167,0.757917,0.225129,4040,5,3348,692
190,0.733333,0.609167,0.167912,5336,6,3348,1988
191,0.7475,0.578333,0.183471,4881,0,3138,1743
192,0.7625,0.635833,0.282337,4086,1,3363,723
193,0.794167,0.559167,0.200254,4258,2,3596,662
194,0.746667,0.631667,0.146133,4342,3,3594,748
195,0.680833,0.47625,0.240667,5084,4,4196,888
196,0.663333,0.59125,0.182833,5538,5,4220,1318
197,0.686667,0.585,0.208342,5923,6,3505,2418
198,0.719167,0.604167,0.245033,5302,0,3296,2006
199,0.746667,0.65125,0.215804,4458,1,3617,841
200,0.776667,0.650417,0.1306,4541,2,3789,752
201,0.768333,0.707083,0.113817,4332,3,3688,644
202,0.815,0.69125,0.222021,3784,4,3152,632
203,0.848333,0.580417,0.1331,3387,5,2825,562
204,0.849167,0.5,0.131221,3285,6,2298,987
205,0.83,0.550833,0.169171,3606,0,2556,1050
206,0.743333,0.757083,0.0908083,3840,1,3272,568
207,0.771667,0.540833,0.200258,4590,2,3840,750
208,0.775,0.402917,0.183463,4656,3,3901,755
209,0.779167,0.583333,0.178479,4390,4,3784,606
210,0.838333,0.5425,0.174138,3846,5,3176,670
211,0.804167,0.465833,0.168537,4475,6,2916,1559
212,0.805833,0.480833,0.164813,4302,0,2778,1524
213,0.771667,0.550833,0.156717,4266,1,3537,729
214,0.783333,0.49125,0.20585,4845,2,4044,801
215,0.731667,0.6575,0.135583,3574,3,3107,467
216,0.71,0.7575,0.19715,4576,4,3777,799
217,0.710833,0.630833,0.184696,4866,5,3843,1023
218,0.716667,0.755,0.22825,4294,6,2773,1521
219,0.7425,0.752917,0.201487,3785,0,2487,1298
220,0.765,0.592083,0.192175,4326,1,3480,846
221,0.775,0.570417,0.151121,4602,2,3695,907
222,0.766667,0.424167,0.200258,4780,3,3896,884
223,0.7175,0.42375,0.164796,4792,4,3980,812
224,0.708333,0.415,0.125621,4905,5,3854,1051
225,0.685833,0.729583,0.211454,4150,6,2646,1504
226,0.676667,0.8175,0.222633,3820,0,2482,1338
227,0.665833,0.712083,0.208954,4338,1,3563,775
228,0.700833,0.578333,0.236329,4725,2,4004,721
229,0.723333,0.575417,0.143667,4694,3,4026,668
230,0.711667,0.654583,0.233208,3805,4,3166,639
231,0.685,0.722917,0.139308,4153,5,3356,797
232,0.6975,0.674167,0.104467,5191,6,3277,1914
233,0.710833,0.77,0.248754,3873,0,2624,1249
234,0.691667,0.47,0.27675,4758,1,3925,833
235,0.640833,0.455417,0.146763,5895,2,4614,1281
236,0.673333,0.605,0.253108,5130,3,4181,949
237,0.684167,0.771667,0.210833,3542,4,3107,435
238,0.7,0.76125,0.0839625,4661,5,3893,768
239,0.68,0.85,0.375617,1115,6,889,226
240,0.707059,0.561765,0.304659,4334,0,2919,1415
241,0.636667,0.554583,0.159825,4634,1,3905,729
242,0.639167,0.548333,0.125008,5204,2,4429,775
243,0.656667,0.597917,0.0833333,5058,3,4370,688
244,0.655,0.639167,0.141796,5115,4,4332,783
245,0.643333,0.727083,0.139929,4727,5,3852,875
246,0.669167,0.716667,0.185325,4484,6,2549,1935
247,0.709167,0.742083,0.206467,4940,0,2419,2521
248,0.673333,0.790417,0.212696,3351,1,2115,1236
249,0.54,0.886957,0.343943,2710,2,2506,204
250,0.599167,0.917083,0.0970208,1996,3,1878,118
251,0.633913,0.939565,0.192748,1842,4,1689,153
252,0.65,0.897917,0.124379,3544,5,3127,417
253,0.66,0.75375,0.153608,5345,6,3595,1750
254,0.653333,0.71375,0.115054,5046,0,3413,1633
255,0.644348,0.692174,0.088913,4713,1,4023,690
256,0.650833,0.7125,0.141804,4763,2,4062,701
257,0.673333,0.697083,0.1673,4785,3,4138,647
258,0.5775,0.709167,0.271146,3659,4,3231,428
259,0.469167,0.590417,0.164183,4760,5,4018,742
260,0.491667,0.718333,0.189675,4511,6,3077,1434
261,0.5075,0.695,0.178483,4274,0,2921,1353
262,0.549167,0.69,0.151742,4539,1,3848,691
263,0.561667,0.88125,0.134954,3641,2,3203,438
264,0.595,0.9,0.0964042,4352,3,3813,539
265,0.628333,0.902083,0.128125,4795,4,4240,555
266,0.609167,0.9725,0.0783667,2395,5,2137,258
267,0.606667,0.8625,0.0783833,5423,6,3647,1776
268,0.634167,0.845,0.0503792,5010,0,3466,1544
269,0.649167,0.848333,0.1107,4630,1,3946,684
270,0.636667,0.885417,0.118171,4120,2,3643,477
271,0.635,0.84875,0.148629,3907,3,3427,480
272,0.616667,0.699167,0.172883,4839,4,4186,653
273,0.564167,0.6475,0.206475,5202,5,4372,830
274,0.41,0.75375,0.292296,2429,6,1949,480
275,0.356667,0.791667,0.222013,2918,0,2302,616
276,0.384167,0.760833,0.0833458,3570,1,3240,330
277,0.484167,0.71,0.205854,4456,2,3970,486
278,0.538333,0.647917,0.17725,4826,3,4267,559
279,0.494167,0.620833,0.134954,4765,4,4126,639
280,0.510833,0.684167,0.0223917,4985,5,4036,949
281,0.521667,0.70125,0.0454042,5409,6,3174,2235
282,0.540833,0.7275,0.06345,5511,0,3114,2397
283,0.570833,0.73375,0.0423042,5117,1,3603,1514
284,0.566667,0.80875,0.143042,4563,2,3896,667
285,0.543333,0.90625,0.24815,2416,3,2199,217
286,0.589167,0.896667,0.141787,2913,4,2623,290
287,0.550833,0.71625,0.223883,3644,5,3115,529
288,0.506667,0.483333,0.258083,5217,6,3318,1899
289,0.511667,0.486667,0.281717,5041,0,3293,1748
290,0.534167,0.579583,0.175379,4570,1,3857,713
291,0.5325,0.701667,0.110087,4748,2,4111,637
292,0.541739,0.895217,0.243339,2424,3,2170,254
293,0.475833,0.63625,0.422275,4195,4,3724,471
294,0.4275,0.574167,0.221396,4304,5,3628,676
295,0.4225,0.629167,0.0926667,4308,6,2809,1499
296,0.421667,0.74125,0.0995125,4381,0,2762,1619
297,0.463333,0.772083,0.118792,4187,1,3488,699
298,0.471667,0.622917,0.166658,4687,2,3992,695
299,0.484167,0.720417,0.148642,3894,3,3490,404
300,0.47,0.812917,0.197763,2659,4,2419,240
301,0.330833,0.585833,0.229479,3747,5,3291,456
302,0.254167,0.8825,0.351371,627,6,570,57
303,0.319167,0.62375,0.176617,3331,0,2446,885
304,0.34,0.703333,0.10635,3669,1,3307,362
305,0.400833,0.68375,0.135571,4068,2,3658,410
306,0.3775,0.71875,0.0820917,4186,3,3816,370
307,0.408333,0.702083,0.136817,3974,4,3656,318
308,0.403333,0.6225,0.271779,4046,5,3576,470
309,0.326667,0.519167,0.189062,3926,6,2770,1156
310,0.348333,0.734583,0.0920542,3649,0,2697,952
311,0.395,0.75875,0.057225,4035,1,3662,373
312,0.408333,0.721667,0.0690375,4205,2,3829,376
313,0.4,0.758333,0.0621958,4109,3,3804,305
314,0.38,0.813333,0.189067,2933,4,2743,190
315,0.324167,0.44625,0.314675,3368,5,2928,440
316,0.356667,0.552917,0.212062,4067,6,2792,1275
317,0.440833,0.458333,0.281721,3717,0,2713,1004
318,0.53,0.587083,0.306596,4486,1,3891,595
319,0.53,0.68875,0.199633,4195,2,3746,449
320,0.456667,0.93,0.136829,1817,3,1672,145
321,0.341667,0.575833,0.305362,3053,4,2914,139
322,0.274167,0.41,0.168533,3392,5,3147,245
323,0.329167,0.502083,0.224496,3663,6,2720,943
324,0.463333,0.684583,0.18595,3520,0,2733,787
325,0.4475,0.91,0.138054,2765,1,2545,220
326,0.416667,0.9625,0.118792,1607,2,1538,69
327,0.440833,0.757917,0.335825,2566,3,2454,112
328,0.373333,0.549167,0.167304,1495,4,935,560
329,0.375,0.64375,0.0988958,2792,5,1697,1095
330,0.375833,0.681667,0.0684208,3068,6,1819,1249
331,0.459167,0.698333,0.208954,3071,0,2261,810
332,0.503478,0.743043,0.142122,3867,1,3614,253
333,0.458333,0.830833,0.258092,2914,2,2818,96
334,0.325,0.613333,0.271158,3613,3,3425,188
335,0.3125,0.524583,0.220158,3727,4,3545,182
336,0.314167,0.625833,0.100754,3940,5,3672,268
337,0.299167,0.612917,0.0957833,3614,6,2908,706
338,0.330833,0.775833,0.0839583,3485,0,2851,634
339,0.385833,0.827083,0.0622083,3811,1,3578,233
340,0.4625,0.949583,0.232583,2594,2,2468,126
341,0.41,0.970417,0.266175,705,3,655,50
342,0.265833,0.58,0.240058,3322,4,3172,150
343,0.290833,0.695833,0.0827167,3620,5,3359,261
344,0.275,0.5075,0.233221,3190,6,2688,502
345,0.220833,0.49,0.0665417,2743,0,2366,377
346,0.238333,0.670833,0.06345,3310,1,3167,143
347,0.2825,0.59,0.14055,3523,2,3368,155
348,0.3175,0.66375,0.0609583,3740,3,3562,178
349,0.4225,0.634167,0.268042,3709,4,3528,181
350,0.375,0.500417,0.260575,3577,5,3399,178
351,0.258333,0.560833,0.243167,2739,6,2464,275
352,0.238333,0.58625,0.169779,2431,0,2211,220
353,0.276667,0.6375,0.172896,3403,1,3143,260
354,0.385833,0.595417,0.0615708,3750,2,3534,216
355,0.428333,0.858333,0.2214,2660,3,2553,107
356,0.423333,0.7575,0.047275,3068,4,2841,227
357,0.373333,0.68625,0.274246,2209,5,2046,163
358,0.3025,0.5425,0.190304,1011,6,856,155
359,0.274783,0.681304,0.155091,754,0,451,303
360,0.321739,0.506957,0.239465,1317,1,887,430
361,0.325,0.7625,0.18845,1162,2,1059,103
362,0.29913,0.503913,0.293961,2302,3,2047,255
363,0.248333,0.574167,0.119412,2423,4,2169,254
364,0.311667,0.636667,0.134337,2999,5,2508,491
365,0.41,0.615833,0.220154,2485,6,1820,665
366,0.37,0.6925,0.192167,2294,0,1608,686
367,0.273043,0.381304,0.329665,1951,1,1707,244
368,0.15,0.44125,0.365671,2236,2,2147,89
369,0.1075,0.414583,0.1847,2368,3,2273,95
370,0.265833,0.524167,0.129987,3272,4,3132,140
371,0.334167,0.542083,0.167908,4098,5,3791,307
372,0.393333,0.531667,0.174758,4521,6,3451,1070
373,0.3375,0.465,0.191542,3425,0,2826,599
374,0.224167,0.701667,0.0989,2376,1,2270,106
375,0.308696,0.646522,0.187552,3598,2,3425,173
376,0.274167,0.8475,0.131221,2177,3,2085,92
377,0.3825,0.802917,0.180967,4097,4,3828,269
378,0.274167,0.5075,0.378108,3214,5,3040,174
379,0.18,0.4575,0.187183,2493,6,2160,333
380,0.166667,0.419167,0.251258,2311,0,2027,284
381,0.19,0.5225,0.231358,2298,1,2081,217
382,0.373043,0.716087,0.34913,2935,2,2808,127
383,0.303333,0.443333,0.415429,3376,3,3267,109
384,0.19,0.4975,0.220158,3292,4,3162,130
385,0.2175,0.45,0.20275,3163,5,3048,115
386,0.173333,0.83125,0.222642,1301,6,1234,67
387,0.1625,0.79625,0.199638,1977,0,1781,196
388,0.218333,0.91125,0.110708,2432,1,2287,145
389,0.3425,0.835833,0.123767,4339,2,3900,439
390,0.294167,0.64375,0.161071,4270,3,3803,467
391,0.341667,0.769583,0.0733958,4075,4,3831,244
392,0.425,0.74125,0.342667,3456,5,3187,269
393,0.315833,0.543333,0.210829,4023,6,3248,775
394,0.2825,0.31125,0.24005,3243,0,2685,558
395,0.269167,0.400833,0.215792,3624,1,3498,126
396,0.39,0.416667,0.261817,4509,2,4185,324
397,0.469167,0.507917,0.189067,4579,3,4275,304
398,0.399167,0.672917,0.187187,3761,4,3571,190
399,0.313333,0.526667,0.178496,4151,5,3841,310
400,0.264167,0.779583,0.121896,2832,6,2448,384
401,0.265833,0.687917,0.175996,2947,0,2629,318
402,0.282609,0.622174,0.1538,3784,1,3578,206
403,0.354167,0.49625,0.147379,4375,2,4176,199
404,0.256667,0.722917,0.133721,2802,3,2693,109
405,0.265,0.562083,0.194037,3830,4,3667,163
406,0.280833,0.54,0.116929,3831,5,3604,227
407,0.224167,0.73125,0.289796,2169,6,1977,192
408,0.1275,0.464583,0.409212,1529,0,1456,73
409,0.2225,0.41125,0.167283,3422,1,3328,94
410,0.319167,0.50875,0.141179,3922,2,3787,135
411,0.348333,0.53125,0.1816,4169,3,4028,141
412,0.316667,0.752917,0.091425,3005,4,2931,74
413,0.343333,0.634583,0.205846,4154,5,3805,349
414,0.346667,0.534583,0.190929,4318,6,2883,1435
415,0.28,0.515833,0.253112,2689,0,2071,618
416,0.28,0.507826,0.229083,3129,1,2627,502
417,0.287826,0.594348,0.205717,3777,2,3614,163
418,0.395833,0.567917,0.234471,4773,3,4379,394
419,0.454167,0.554583,0.190913,5062,4,4546,516
420,0.4075,0.7375,0.237567,3487,5,3241,246
421,0.290833,0.395833,0.421642,2732,6,2415,317
422,0.279167,0.41,0.205229,3389,0,2874,515
423,0.366667,0.490833,0.268033,4322,1,4069,253
424,0.359167,0.395833,0.193417,4363,2,4134,229
425,0.344348,0.804783,0.179117,1834,3,1769,65
426,0.485833,0.615417,0.226987,4990,4,4665,325
427,0.353333,0.657083,0.144904,3194,5,2948,246
428,0.414167,0.62125,0.161079,4066,6,3110,956
429,0.325833,0.403333,0.334571,3423,0,2713,710
430,0.243333,0.50625,0.228858,3333,1,3130,203
431,0.258333,0.456667,0.200875,3956,2,3735,221
432,0.404167,0.513333,0.345779,4916,3,4484,432
433,0.5275,0.5675,0.441563,5382,4,4896,486
434,0.410833,0.407083,0.4148,4569,5,4122,447
435,0.2875,0.350417,0.22575,4118,6,3150,968
436,0.361739,0.476957,0.222587,4911,0,3253,1658
437,0.466667,0.489167,0.207713,5298,1,4460,838
438,0.565,0.6175,0.23695,5847,2,5085,762
439,0.5725,0.507083,0.115062,6312,3,5315,997
440,0.5575,0.579583,0.149883,6192,4,5187,1005
441,0.435833,0.842083,0.113192,4378,5,3830,548
442,0.514167,0.755833,0.110704,7836,6,4681,3155
443,0.4725,0.81,0.126883,5892,0,3685,2207
444,0.545,0.72875,0.162317,6153,1,5171,982
445,0.560833,0.807917,0.121271,6093,2,5042,1051
446,0.531667,0.82125,0.0895583,6230,3,5108,1122
447,0.554167,0.83125,0.117562,6871,4,5537,1334
448,0.601667,0.694167,0.1163,8362,5,5893,2469
449,0.5025,0.885417,0.192783,3372,6,2339,1033
450,0.4375,0.880833,0.220775,4996,0,3464,1532
451,0.445833,0.477917,0.386821,5558,1,4763,795
452,0.323333,0.29,0.187192,5102,2,4571,531
453,0.484167,0.48125,0.291671,5698,3,5024,674
454,0.494167,0.439167,0.31965,6133,4,5299,834
455,0.37,0.580833,0.138067,5459,5,4663,796
456,0.424167,0.738333,0.250617,6235,6,3934,2301
457,0.425833,0.67625,0.172267,6041,0,3694,2347
458,0.433913,0.504348,0.312139,5936,1,4728,1208
459,0.466667,0.396667,0.100133,6772,2,5424,1348
460,0.541667,0.469583,0.180975,6436,3,5378,1058
461,0.435,0.374167,0.219529,6457,4,5265,1192
462,0.403333,0.377083,0.300388,6460,5,4653,1807
463,0.4375,0.254167,0.274871,6857,6,3605,3252
464,0.5,0.275833,0.232596,5169,0,2939,2230
465,0.489167,0.3175,0.358196,5585,1,4680,905
466,0.446667,0.435,0.249375,5918,2,5099,819
467,0.348696,0.469565,0.295274,4862,3,4380,482
468,0.3975,0.46625,0.290429,5409,4,4746,663
469,0.4425,0.408333,0.155471,6398,5,5146,1252
470,0.495,0.502917,0.190917,7460,6,4665,2795
471,0.606667,0.507917,0.225129,7132,0,4286,2846
472,0.664167,0.561667,0.284829,6370,1,5172,1198
473,0.608333,0.390417,0.273629,6691,2,5702,989
474,0.463333,0.569167,0.167912,4367,3,4020,347
475,0.498333,0.6125,0.0659292,6565,4,5719,846
476,0.526667,0.694583,0.149871,7290,5,5950,1340
477,0.57,0.682917,0.283587,6624,6,4083,2541
478,0.396667,0.835417,0.344546,1027,0,907,120
479,0.321667,0.766667,0.303496,3214,1,3019,195
480,0.413333,0.454167,0.249383,5633,2,5115,518
481,0.476667,0.427917,0.118792,6196,3,5541,655
482,0.498333,0.756667,0.176625,5026,4,4551,475
483,0.4575,0.400833,0.347633,6233,5,5219,1014
484,0.376667,0.489583,0.129975,4220,6,3100,1120
485,0.458333,0.587083,0.116908,6304,0,4075,2229
486,0.464167,0.57,0.171638,5572,1,4907,665
487,0.613333,0.659583,0.156096,5740,2,5087,653
488,0.564167,0.797083,0.138058,6169,3,5502,667
489,0.56,0.768333,0.133696,6421,4,5657,764
490,0.6275,0.735417,0.162938,6296,5,5227,1069
491,0.621667,0.756667,0.152992,6883,6,4387,2496
492,0.5625,0.74,0.149879,6359,0,4224,2135
493,0.5375,0.664167,0.230721,6273,1,5265,1008
494,0.581667,0.685833,0.296029,5728,2,4990,738
495,0.575,0.744167,0.216412,4717,3,4097,620
496,0.505833,0.552083,0.314063,6572,4,5546,1026
497,0.533333,0.360417,0.236937,7030,5,5711,1319
498,0.564167,0.480417,0.123133,7429,6,4807,2622
499,0.6125,0.57625,0.225117,6118,0,3946,2172
500,0.573333,0.789583,0.212692,2843,1,2501,342
501,0.611667,0.794583,0.147392,5115,2,4490,625
502,0.636667,0.697917,0.122512,7424,3,6433,991
503,0.593333,0.52,0.229475,7384,4,6142,1242
504,0.564167,0.523333,0.136817,7639,5,6118,1521
505,0.6,0.45625,0.083975,8294,6,4884,3410
506,0.620833,0.530417,0.254367,7129,0,4425,2704
507,0.598333,0.81125,0.233204,4359,1,3729,630
508,0.615,0.765833,0.118167,6073,2,5254,819
509,0.621667,0.774583,0.102,5260,3,4494,766
510,0.655,0.716667,0.172896,6770,4,5711,1059
511,0.68,0.747083,0.14055,6734,5,5317,1417
512,0.6925,0.7325,0.198992,6536,6,3681,2855
513,0.69,0.697083,0.215171,6591,0,3308,3283
514,0.7125,0.67625,0.196521,6043,1,3486,2557
515,0.7225,0.684583,0.2954,5743,2,4863,880
516,0.656667,0.67,0.134329,6855,3,6110,745
517,0.68,0.492917,0.195279,7338,4,6238,1100
518,0.654167,0.755417,0.237563,4127,5,3594,533
519,0.583333,0.549167,0.186562,8120,6,5325,2795
520,0.6025,0.493333,0.184087,7641,0,5147,2494
521,0.5975,0.487083,0.284833,6998,1,5927,1071
522,0.540833,0.613333,0.209575,7001,2,6033,968
523,0.554167,0.61125,0.077125,7055,3,6028,1027
524,0.6025,0.567083,0.15735,7494,4,6456,1038
525,0.649167,0.467917,0.175383,7736,5,6248,1488
526,0.710833,0.437083,0.144287,7498,6,4790,2708
527,0.726667,0.538333,0.133721,6598,0,4374,2224
528,0.720833,0.587917,0.207713,6664,1,5647,1017
529,0.653333,0.833333,0.214546,4972,2,4495,477
530,0.655833,0.582083,0.343279,7421,3,6248,1173
531,0.648333,0.569583,0.253733,7363,4,6183,1180
532,0.639167,0.589583,0.176617,7665,5,6102,1563
533,0.631667,0.504167,0.166667,7702,6,4739,2963
534,0.5925,0.59875,0.144904,6978,0,4344,2634
535,0.568333,0.777917,0.174746,5099,1,4446,653
536,0.688333,0.69,0.148017,6825,2,5857,968
537,0.7825,0.592083,0.113812,6211,3,5339,872
538,0.805833,0.567917,0.118787,5905,4,5127,778
539,0.7775,0.57375,0.182842,5823,5,4859,964
540,0.731667,0.534583,0.179721,7458,6,4801,2657
541,0.743333,0.479167,0.145525,6891,0,4340,2551
542,0.715833,0.504167,0.300383,6779,1,5640,1139
543,0.630833,0.373333,0.347642,7442,2,6365,1077
544,0.6975,0.36,0.271775,7335,3,6258,1077
545,0.749167,0.4225,0.17165,6879,4,5958,921
546,0.834167,0.48875,0.165417,5463,5,4634,829
547,0.765,0.60125,0.161071,5687,6,4232,1455
548,0.815833,0.51875,0.168529,5531,0,4110,1421
549,0.781667,0.447083,0.195267,6227,1,5323,904
550,0.780833,0.492083,0.126237,6660,2,5608,1052
551,0.789167,0.53875,0.13495,7403,3,4841,2562
552,0.8275,0.457917,0.194029,6241,4,4836,1405
553,0.828333,0.450833,0.146142,6207,5,4841,1366
554,0.861667,0.492083,0.163554,4840,6,3392,1448
555,0.8225,0.57375,0.125629,4672,0,3469,1203
556,0.710833,0.683333,0.180975,6569,1,5571,998
557,0.720833,0.6675,0.151737,6290,2,5336,954
558,0.716667,0.633333,0.151733,7264,3,6289,975
559,0.715833,0.529583,0.146775,7446,4,6414,1032
560,0.731667,0.485833,0.08085,7499,5,5988,1511
561,0.703333,0.699167,0.143679,6969,6,4614,2355
562,0.745833,0.717917,0.166667,6031,0,4111,1920
563,0.763333,0.645,0.164187,6830,1,5742,1088
564,0.818333,0.505833,0.114429,6786,2,5865,921
565,0.793333,0.577083,0.137442,5713,3,4914,799
566,0.77,0.600417,0.165429,6591,4,5703,888
567,0.665833,0.844167,0.208967,5870,5,5123,747
568,0.595833,0.865417,0.2133,4459,6,3195,1264
569,0.6675,0.7625,0.0939208,7410,0,4866,2544
570,0.741667,0.694167,0.138683,6966,1,5831,1135
571,0.750833,0.655,0.211454,7592,2,6452,1140
572,0.724167,0.45,0.1648,8173,3,6790,1383
573,0.776667,0.596667,0.284813,6861,4,5825,1036
574,0.781667,0.594583,0.152992,6904,5,5645,1259
575,0.755833,0.613333,0.15735,6685,6,4451,2234
576,0.721667,0.62375,0.170396,6597,0,4444,2153
577,0.730833,0.66875,0.153617,7105,1,6065,1040
578,0.713333,0.704167,0.165425,7216,2,6248,968
579,0.7175,0.6775,0.141179,7580,3,6506,1074
580,0.7525,0.659583,0.129354,7261,4,6278,983
581,0.765833,0.6425,0.215792,7175,5,5847,1328
582,0.793333,0.613333,0.257458,6824,6,4479,2345
583,0.769167,0.6525,0.290421,5464,0,3757,1707
584,0.7525,0.654167,0.129354,7013,1,5780,1233
585,0.735833,0.70375,0.116908,7273,2,5995,1278
586,0.75,0.672917,0.1107,7534,3,6271,1263
587,0.755833,0.620417,0.1561,7286,4,6090,1196
588,0.715833,0.715833,0.238813,5786,5,4721,1065
589,0.6925,0.732917,0.206479,6299,6,4052,2247
590,0.700833,0.530417,0.122512,6544,0,4362,2182
591,0.720833,0.545417,0.136212,6883,1,5676,1207
592,0.726667,0.686667,0.169158,6784,2,5656,1128
593,0.706667,0.619583,0.169771,7347,3,6149,1198
594,0.719167,0.519167,0.141796,7605,4,6267,1338
595,0.723333,0.570833,0.231354,7148,5,5665,1483
596,0.678333,0.603333,0.177867,7865,6,5038,2827
597,0.635833,0.711667,0.08645,4549,0,3341,1208
598,0.635833,0.734167,0.129979,6530,1,5504,1026
599,0.649167,0.67375,0.0727708,7006,2,5925,1081
600,0.6675,0.677083,0.0702833,7375,3,6281,1094
601,0.695833,0.635833,0.0845958,7765,4,6402,1363
602,0.7025,0.615,0.0721458,7582,5,6257,1325
603,0.661667,0.712917,0.244408,6053,6,4224,1829
604,0.653333,0.845833,0.228858,5255,0,3772,1483
605,0.703333,0.730417,0.128733,6917,1,5928,989
606,0.728333,0.62,0.190925,7040,2,6105,935
607,0.685,0.552083,0.112562,7697,3,6520,1177
608,0.706667,0.590417,0.0771167,7713,4,6541,1172
609,0.764167,0.5875,0.168533,7350,5,5917,1433
610,0.753333,0.638333,0.113187,6140,6,3788,2352
611,0.696667,0.815,0.0640708,5810,0,3197,2613
612,0.7075,0.790833,0.151121,6034,1,4069,1965
613,0.725833,0.755,0.236321,6864,2,5997,867
614,0.736667,0.74125,0.187808,7112,3,6280,832
615,0.696667,0.810417,0.142421,6203,4,5592,611
616,0.703333,0.73625,0.171646,7504,5,6459,1045
617,0.659167,0.799167,0.281104,5976,6,4419,1557
618,0.61,0.5475,0.224496,8227,0,5657,2570
619,0.583333,0.50375,0.258713,7525,1,6407,1118
620,0.5775,0.52,0.0920542,7767,2,6697,1070
621,0.599167,0.577083,0.131846,7870,3,6820,1050
622,0.6125,0.637083,0.0827208,7804,4,6750,1054
623,0.633333,0.6725,0.103863,8009,5,6630,1379
624,0.608333,0.501667,0.247521,8714,6,5554,3160
625,0.58,0.57,0.0901833,7333,0,5167,2166
626,0.580833,0.734583,0.151742,6869,1,5847,1022
627,0.623333,0.8725,0.357587,4073,2,3702,371
628,0.5525,0.536667,0.215175,7591,3,6803,788
629,0.546667,0.618333,0.118167,7720,4,6781,939
630,0.599167,0.66875,0.154229,8167,5,6917,1250
631,0.65,0.646667,0.283583,8395,6,5883,2512
632,0.529167,0.467083,0.223258,7907,0,5453,2454
633,0.514167,0.492917,0.142404,7436,1,6435,1001
634,0.55,0.57,0.236321,7538,2,6693,845
635,0.635,0.630833,0.2444,7733,3,6946,787
636,0.65,0.690833,0.134342,7393,4,6642,751
637,0.619167,0.69,0.164179,7415,5,6370,1045
638,0.5425,0.542917,0.227604,8555,6,5966,2589
639,0.526667,0.583333,0.134958,6889,0,4874,2015
640,0.520833,0.649167,0.0908042,6778,1,6015,763
641,0.590833,0.871667,0.104475,4639,2,4324,315
642,0.6575,0.79375,0.0665458,7572,3,6844,728
643,0.6575,0.722917,0.117546,7328,4,6437,891
644,0.615,0.6275,0.10635,8156,5,6640,1516
645,0.554167,0.664167,0.268025,7965,6,4934,3031
646,0.415833,0.708333,0.141162,3510,0,2729,781
647,0.383333,0.709583,0.189679,5478,1,4604,874
648,0.446667,0.761667,0.1903,6392,2,5791,601
649,0.514167,0.630833,0.187821,7691,3,6911,780
650,0.435,0.463333,0.181596,7570,4,6736,834
651,0.4375,0.539167,0.235092,7282,5,6222,1060
652,0.393333,0.494583,0.146142,7109,6,4857,2252
653,0.521667,0.640417,0.278612,6639,0,4559,2080
654,0.561667,0.7075,0.296037,5875,1,5115,760
655,0.468333,0.558333,0.182221,7534,2,6612,922
656,0.455833,0.692917,0.101371,7461,3,6482,979
657,0.5225,0.728333,0.236937,7509,4,6501,1008
658,0.563333,0.815,0.134954,5424,5,4671,753
659,0.484167,0.572917,0.117537,8090,6,5284,2806
660,0.464167,0.51,0.166054,6824,0,4692,2132
661,0.4875,0.568333,0.0814833,7058,1,6228,830
662,0.544167,0.641667,0.0945458,7466,2,6625,841
663,0.5875,0.63625,0.0727792,7693,3,6898,795
664,0.55,0.800417,0.124375,7359,4,6484,875
665,0.545833,0.807083,0.132467,7444,5,6262,1182
666,0.53,0.72,0.235692,7852,6,5209,2643
667,0.4775,0.694583,0.398008,4459,0,3461,998
668,0.44,0.88,0.3582,22,1,20,2
669,0.318182,0.825455,0.213009,1096,2,1009,87
670,0.3575,0.666667,0.166667,5566,3,5147,419
671,0.365833,0.581667,0.157346,5986,4,5520,466
672,0.355,0.522083,0.266175,5847,5,5229,618
673,0.343333,0.49125,0.270529,5138,6,4109,1029
674,0.325833,0.532917,0.179108,5107,0,3906,1201
675,0.319167,0.494167,0.236325,5259,1,4881,378
676,0.280833,0.567083,0.173513,5686,2,5220,466
677,0.295833,0.5475,0.304108,5035,3,4709,326
678,0.352174,0.333478,0.347835,5315,4,4975,340
679,0.361667,0.540833,0.214558,5992,5,5283,709
680,0.389167,0.645417,0.0578458,6536,6,4446,2090
681,0.420833,0.659167,0.1275,6852,0,4562,2290
682,0.485,0.741667,0.173517,6269,1,5172,1097
683,0.343333,0.662917,0.342046,4094,2,3767,327
684,0.289167,0.552083,0.199625,5495,3,5122,373
685,0.321667,0.620417,0.152987,5445,4,5125,320
686,0.345,0.524583,0.171025,5698,5,5214,484
687,0.325,0.545417,0.179729,5629,6,4316,1313
688,0.3425,0.692917,0.227612,4669,0,3747,922
689,0.380833,0.623333,0.235067,5499,1,5050,449
690,0.374167,0.685,0.082725,5634,2,5100,534
691,0.353333,0.61375,0.103246,5146,3,4531,615
692,0.34,0.580417,0.0528708,2425,4,1470,955
693,0.368333,0.56875,0.148021,3910,5,2307,1603
694,0.278333,0.404583,0.376871,2277,6,1745,532
695,0.245833,0.468333,0.1505,2424,0,2115,309
696,0.313333,0.535417,0.04665,5087,1,4750,337
697,0.291667,0.786667,0.237562,3959,2,3836,123
698,0.296667,0.50625,0.210821,5260,3,5062,198
699,0.28087,0.555652,0.115522,5323,4,5080,243
700,0.298333,0.649583,0.0584708,5668,5,5306,362
701,0.298333,0.806667,0.0597042,5191,6,4240,951
702,0.3475,0.823333,0.124379,4649,0,3757,892
703,0.4525,0.7675,0.0827208,6234,1,5679,555
704,0.475833,0.73375,0.174129,6606,2,6055,551
705,0.438333,0.485,0.324021,5729,3,5398,331
706,0.255833,0.50875,0.174754,5375,4,5035,340
707,0.320833,0.764167,0.1306,5008,5,4659,349
708,0.381667,0.91125,0.101379,5582,6,4429,1153
709,0.384167,0.905417,0.157975,3228,0,2787,441
710,0.435833,0.925,0.190308,5170,1,4841,329
711,0.353333,0.596667,0.296037,5501,2,5219,282
712,0.2975,0.538333,0.162937,5319,3,5009,310
713,0.295833,0.485833,0.174129,5532,4,5107,425
714,0.281667,0.642917,0.131229,5611,5,5182,429
715,0.324167,0.650417,0.10635,5047,6,4280,767
716,0.3625,0.83875,0.100742,3786,0,3248,538
717,0.393333,0.907083,0.0982583,4585,1,4373,212
718,0.410833,0.66625,0.221404,5557,2,5124,433
719,0.3325,0.625417,0.184092,5267,3,4934,333
720,0.33,0.667917,0.132463,4128,4,3814,314
721,0.326667,0.556667,0.374383,3623,5,3402,221
722,0.265833,0.44125,0.407346,1749,6,1544,205
723,0.245833,0.515417,0.133083,1787,0,1379,408
724,0.231304,0.791304,0.0772304,920,1,746,174
725,0.291304,0.734783,0.168726,1013,2,573,440
726,0.243333,0.823333,0.316546,441,3,432,9
727,0.254167,0.652917,0.350133,2114,4,1867,247
728,0.253333,0.59,0.155471,3095,5,2451,644
729,0.253333,0.752917,0.124383,1341,6,1182,159
730,0.255833,0.483333,0.350754,1796,0,1432,364
731,0.215833,0.5775,0.154846,2729,1,2290,439
